 ####
 #  ###
 #$   #
##@$. #
#   .##
#    #
#  $ #
#   .#
######