######
#  @ #
###$$######
#    .    #
#   $     #
##.       #
 #.       #
 ##########