  ####
###  #
#@ .$#######
#   $     .#
# # $  #####
#      #  .#
#          #
#          #
############